ACCAACCAACTTTCGATCTCTTGT	CATCTTTAAGATGTTGACGTGCCTC	nCoV-1
CTGTTTTACAGGTTCGCGACGT	TAAGGATCAGTGCCAAGCTCGT	nCoV-2
CGGTAATAAAGGAGCTGGTGGC	AAGGTGTCTGCAATTCATAGCTCT	nCoV-3
GGTGTATACTGCTGCCGTGAAC	CACAAGTAGTGGCACCTTCTTTAGT	nCoV-4
TGGTGAAACTTCATGGCAGACG	ATTGATGTTGACTTTCTCTTTTTGGAGT	nCoV-5
GGTGTTGTTGGAGAAGGTTCCG	TAGCGGCCTTCTGTAAAACACG	nCoV-6
ATCAGAGGCTGCTCGTGTTGTA	TGCACAGGTGACAATTTGTCCA	nCoV-7
AGAGTTTCTTAGAGACGGTTGGGA	GCTTCAACAGCTTCACTAGTAGGT	nCoV-8
TCCCACAGAAGTGTTAACAGAGGA	ATGACAGCATCTGCCACAACAC	nCoV-9
TGAGAAGTGCTCTGCCTATACAGT	TCATCTAACCAATCTTCTTCTTGCTCT	nCoV-10
GGAATTTGGTGCCACTTCTGCT	TCATCAGATTCAACTTGCATGGCA	nCoV-11
AAACATGGAGGAGGTGTTGCAG	TTCACTCTTCATTTCCAAAAAGCTTGA	nCoV-12
TCGCACAAATGTCTACTTAGCTGT	ACCACAGCAGTTAAAACACCCT	nCoV-13
CATCCAGATTCTGCCACTCTTGT	AGTTTCCACACAGACAGGCATT	nCoV-14
ACAGTGCTTAAAAAGTGTAAAAGTGCC	AACAGAAACTGTAGCTGGCACT	nCoV-15
AATTTGGAAGAAGCTGCTCGGT	CACAACTTGCGTGTGGAGGTTA	nCoV-16
CTTCTTTCTTTGAGAGAAGTGAGGACT	TTTGTTGGAGTGTTAACAATGCAGT	nCoV-17
TGGAAATACCCACAAGTTAATGGTTTAAC	AGCTTGTTTACCACACGTACAAGG	nCoV-18
GCTGTTATGTACATGGGCACACT	TGTCCAACTTAGGGTCAATTTCTGT	nCoV-19
ACAAAGAAAACAGTTACACAACAACCA	ACGTGGCTTTATTAGTTGCATTGTT	nCoV-20
TGGCTATTGATTATAAACACTACACACCC	TAGATCTGTGTGGCCAACCTCT	nCoV-21
ACTACCGAAGTTGTAGGAGACATTATACT	ACAGTATTCTTTGCTATAGTAGTCGGC	nCoV-22
ACAACTACTAACATAGTTACACGGTGT	ACCAGTACAGTAGGTTGCAATAGTG	nCoV-23
AGGCATGCCTTCTTACTGTACTG	ACATTCTAACCATAGCTGAAATCGGG	nCoV-24
GCAATTGTTTTTCAGCTATTTTGCAGT	ACTGTAGTGACAAGTCTCTCGCA	nCoV-25
TTGTGATACATTCTGTGCTGGTAGT	TCCGCACTATCACCAACATCAG	nCoV-26
ACTACAGTCAGCTTATGTGTCAACC	AATACAAGCACCAAGGTCACGG	nCoV-27
ACATAGAAGTTACTGGCGATAGTTGT	TGTTTAGACATGACATGAACAGGTGT	nCoV-28
ACTTGTGTTCCTTTTTGTTGCTGC	AGTGTACTCTATAAGTTTTGATGGTGTGT	nCoV-29
GCACAACTAATGGTGACTTTTTGCA	ACCACTAGTAGATACACAAACACCAG	nCoV-30
TTCTGAGTACTGTAGGCACGGC	ACAGAATAAACACCAGGTAAGAATGAGT	nCoV-31
TGGTGAATACAGTCATGTAGTTGCC	AGCACATCACTACGCAACTTTAGA	nCoV-32
ACTTTTGAAGAAGCTGCGCTGT	TGGACAGTAAACTACGTCATCAAGC	nCoV-33
TCCCATCTGGTAAAGTTGAGGGT	AGTGAAATTGGGCCTCATAGCA	nCoV-34
TGTTCGCATTCAACCAGGACAG	ACTTCATAGCCACAAGGTTAAAGTCA	nCoV-35
TTAGCTTGGTTGTACGCTGCTG	GAACAAAGACCATTGAGTACTCTGGA	nCoV-36
ACACACCACTGGTTGTTACTCAC	GTCCACACTCTCCTAGCACCAT	nCoV-37
ACTGTGTTATGTATGCATCAGCTGT	CACCAAGAGTCAGTCTAAAGTAGCG	nCoV-38
AGTATTGCCCTATTTTCTTCATAACTGGT	TGTAACTGGACACATTGAGCCC	nCoV-39
TGCACATCAGTAGTCTTACTCTCAGT	CATGGCTGCATCACGGTCAAAT	nCoV-40
GTTCCCTTCCATCATATGCAGCT	TGGTATGACAACCATTAGTTTGGCT	nCoV-41
TGCAAGAGATGGTTGTGTTCCC	CCTACCTCCCTTTGTTGTGTTGT	nCoV-42
TACGACAGATGTCTTGTGCTGC	AGCAGCATCTACAGCAAAAGCA	nCoV-43
TGCCACAGTACGTCTACAAGCT	AACCTTTCCACATACCGCAGAC	nCoV-44
TACCTACAACTTGTGCTAATGACCC	AAATTGTTTCTTCATGTTGGTAGTTAGAGA	nCoV-45
TGTCGCTTCCAAGAAAAGGACG	CACGTTCACCTAAGTTGGCGTA	nCoV-46
AGGACTGGTATGATTTTGTAGAAAACCC	AATAACGGTCAAAGAGTTTTAACCTCTC	nCoV-47
TGTTGACACTGACTTAACAAAGCCT	TAGATTACCAGAAGCAGCGTGC	nCoV-48
AGGAATTACTTGTGTATGCTGCTGA	TGACGATGACTTGGTTAGCATTAATACA	nCoV-49
GTTGATAAGTACTTTGATTGTTACGATGGT	TAACATGTTGTGCCAACCACCA	nCoV-50
TCAATAGCCGCCACTAGAGGAG	AGTGCATTAACATTGGCCGTGA	nCoV-51
CATCAGGAGATGCCACAACTGC	GTTGAGAGCAAAATTCATGAGGTCC	nCoV-52
AGCAAAATGTTGGACTGAGACTGA	AGCCTCATAAAACTCAGGTTCCC	nCoV-53
TGAGTTAACAGGACACATGTTAGACA	AACCAAAAACTTGTCCATTAGCACA	nCoV-54
ACTCAACTTTACTTAGGAGGTATGAGCT	GGTGTACTCTCCTATTTGTACTTTACTGT	nCoV-55
ACCTAGACCACCACTTAACCGA	ACACTATGCGAGCAGAAGGGTA	nCoV-56
ATTCTACACTCCAGGGACCACC	GTAATTGAGCAGGGTCGCCAAT	nCoV-57
TGATTTGAGTGTTGTCAATGCCAGA	CTTTTCTCCAAGCAGGGTTACGT	nCoV-58
TCACGCATGATGTTTCATCTGCA	AAGAGTCCTGTTACATTTTCAGCTTG	nCoV-59
TGATAGAGACCTTTATGACAAGTTGCA	GGTACCAACAGCTTCTCTAGTAGC	nCoV-60
TGTTTATCACCCGCGAAGAAGC	ATCACATAGACAACAGGTGCGC	nCoV-61
GGCACATGGCTTTGAGTTGACA	GTTGAACCTTTCTACAAGCCGC	nCoV-62
TGTTAAGCGTGTTGACTGGACT	ACAAACTGCCACCATCACAACC	nCoV-63
TCGATAGATATCCTGCTAATTCCATTGT	AGTCTTGTAAAAGTGTTCCAGAGGT	nCoV-64
GCTGGCTTTAGCTTGTGGGTTT	TGTCAGTCATAGAACAAACACCAATAGT	nCoV-65
GGGTGTGGACATTGCTGCTAAT	TCAATTTCCATTTGACTCCTGGGT	nCoV-66
GTTGTCCAACAATTACCTGAAACTTACT	CAACCTTAGAAACTACAGATAAATCTTGGG	nCoV-67
ACAGGTTCATCTAAGTGTGTGTGT	CTCCTTTATCAGAACCAGCACCA	nCoV-68
TGTCGCAAAATATACTCAACTGTGTCA	TCTTTATAGCCACGGAACCTCCA	nCoV-69
ACAAAAGAAAATGACTCTAAAGAGGGTTT	TGACCTTCTTTTAAAGACATAACAGCAG	nCoV-70
ACAAATCCAATTCAGTTGTCTTCCTATTC	TGGAAAAGAAAGGTAAGAACAAGTCCT	nCoV-71
ACACGTGGTGTTTATTACCCTGAC	ACTCTGAACTCACTTTCCATCCAAC	nCoV-72
CAATTTTGTAATGATCCATTTTTGGGTGT	CACCAGCTGTCCAACCTGAAGA	nCoV-73
ACATCACTAGGTTTCAAACTTTACTTGC	GCAACACAGTTGCTGATTCTCTTC	nCoV-74
AGAGTCCAACCAACAGAATCTATTGT	ACCACCAACCTTAGAATCAAGATTGT	nCoV-75
AGGGCAAACTGGAAAGATTGCT	ACACCTGTGCCTGTTAAACCAT	nCoV-76
CCAGCAACTGTTTGTGGACCTA	CAGCCCCTATTAAACAGCCTGC	nCoV-77
CAACTTACTCCTACTTGGCGTGT	TGTGTACAAAAACTGCCATATTGCA	nCoV-78
GTGGTGATTCAACTGAATGCAGC	CATTTCATCTGTGAGCAAAGGTGG	nCoV-79
TTGCCTTGGTGATATTGCTGCT	TGGAGCTAAGTTGTTTAACAAGCG	nCoV-80
GCACTTGGAAAACTTCAAGATGTGG	GTGAAGTTCTTTTCTTGTGCAGGG	nCoV-81
GGGCTATCATCTTATGTCCTTCCCT	TGCCAGAGATGTCACCTAAATCAA	nCoV-82
TCCTTTGCAACCTGAATTAGACTCA	TTTGACTCCTTTGAGCACTGGC	nCoV-83
TGCTGTAGTTGTCTCAAGGGCT	AGGTGTGAGTAAACTGTTACAAACAAC	nCoV-84
ACTAGCACTCTCCAAGGGTGTT	ACACAGTCTTTTACTCCAGATTCCC	nCoV-85
TCAGGTGATGGCACAACAAGTC	ACGAAAGCAAGAAAAAGAAGTACGC	nCoV-86
CGACTACTAGCGTGCCTTTGTA	ACTAGGTTCCATTGTTCAAGGAGC	nCoV-87
CCATGGCAGATTCCAACGGTAC	TGGTCAGAATAGTGCCATGGAGT	nCoV-88
GTACGCGTTCCATGTGGTCATT	ACCTGAAAGTCAACGAGATGAAACA	nCoV-89
ACACAGACCATTCCAGTAGCAGT	TGAAATGGTGAATTGCCCTCGT	nCoV-90
TCACTACCAAGAGTGTGTTAGAGGT	TTCAAGTGAGAACCAAAAGATAATAAGCA	nCoV-91
TTTGTGCTTTTTAGCCTTTCTGCT	AGGTTCCTGGCAATTAATTGTAAAAGG	nCoV-92
TGAGGCTGGTTCTAAATCACCCA	AGGTCTTCCTTGCCATGTTGAG	nCoV-93
GGCCCCAAGGTTTACCCAATAA	TTTGGCAATGTTGTTCCTTGAGG	nCoV-94
TGAGGGAGCCTTGAATACACCA	CAGTACGTTTTTGCCGAGGCTT	nCoV-95
GCCAACAACAACAAGGCCAAAC	TAGGCTCTGTTGGTGGGAATGT	nCoV-96
TGGATGACAAAGATCCAAATTTCAAAGA	ACACACTGATTAAAGATTGCTATGTGAG	nCoV-97
AACAATTGCAACAATCCATGAGCA	TTCTCCTAAGAAGCTATTAAAATCACATGG	nCoV-98

